just for show: ra vẻ chứ có làm méo đâu
tobe overly dramatic: làm quá
on the tip in my tongue: biết nhưng ko nhớ rõ
off the top on my head: nhảy ra trong đầu
Put the cart before the horse: cầm đèn chạy trước ô tô
Get/come (down) off your high horse: ngừng ra vẻ kiêu ngạo
Lock the barn door after the horse is gone: mất bò mới lo làm chuồng
As strong as a horse/ox: rất khỏe
Back the wrong horse: chọn nhầm người để tin tưởng, giao phó
Beat a dead horse: cố gắng vô ích
A pain in the neck: khó chịu vl
Bring something to light: làm sáng tỏ / đưa ra ánh sáng điều gì đó …
Change horses in midstream: Thay ngựa giữa dòng
make no bone about sth: nói thẳng, nói _____
A dark horse: người mờ nhạt, ít được biết đến nhưng có tài năng ẩn giấu.
Hold one’s horses=keep calm= keep sb's shirt on: bình tĩnh
Look a gift horse in the mouth: kén cá chọn canh
Music to your ears = something you are pleased to hear about = điều gì đó khiến bạn hạnh phúc vui vẻ khi nghe
to dampen your spirit: làm giảm tinh thần của mài
Fit the bill = to be suitable for something : thích hợp cho một mục đích nào đó
I am in the dark = I don’t know
A pig in a poke: mua ngay mà ko test chất lượng
A red as a beetroot: đỏ mặt vì xấu hổ
Prevention is better than cure = An apple a day, keeps the Dr away
think outside the box: suy nghĩ khác biệt
pay their last respects: bày tỏ lòng kính trọng cuối cùng với death
to express oneself through art: biểu hiện bản thân thông qua nghệ thuật
# Law-abiding citizen: Những công dân tuân thủ pháp luật
# Unlawful citizens: những công dân sống ngoài vòng pháp luật
# Exemplary citizen: công dân gương mẫu
# Upstanding citizen: công dân ngay thẳng, chính trực
# Senior citizens: công dân cao tuổi
# Citizen right: quyền công dân
Leverage the awareness of citizens about something : Nâng cao nhận thức của công dân
Conduct a citizen arrest: Thực hiện lệnh bắt công dân
Exemplary behavior: cách cư xử mẫu mực
Sensible behavior: cách cư xử thấu tình đạt lý
Bizarre behavior: cách cư xử kỳ lạ, khác thường
Outrageous behavior: cách cư xử xúc phạm, làm tổn thương người khác
Reckless behavior: cách cư xử vội vàng, hấp tấp, chưa suy nghĩ thấu đáo
Discriminatory behavior:cách cư xử thể có tính phân biệt, đối xử
Deviant behavior: cư xử không đúng chuẩn mực
Loutish behavior: cư xử vụng về
Undesirable behavior: cư xử chê trách khó ưa
Unfounded rumour = baseless rumour: tin đồn thất thiệt
take a dim view of sth: có quan điểm tiêu cực về cái gì đó
Give a competitive advantage of learning: mang lại lợi thế cạnh tranh của___
Depict the affection of mass media: mô tả tác động của truyền thông đại chúng
In the early first millennium: thiên niên kỷ đầu tiên
hold advanced views about sth : có quan điểm mới mẻ, hiện đại về cái gì đó
Grandiose nature: thiên nhiên hùng vĩ
Two-earner household = Dual-income family : Gia đình có bố và mẹ cùng đi làm để nuôi dạy con cái
The ongoing pressures of day-to-day life: áp lực liên tục của cuộc sống hằng ngày
Innocuous-looking: nhìn hoàn toàn vô hại
Promote a sense of national pride: củng cố lòng tự hào dân tộc
Trigger public outcry: thổi bùng cơn giận dữ trong dư luận
Act a springboard for something: bàn đạp, bước đệm cho những cú hích trong tương lai
- inadequate infrastructure (n): cơ sở hạ tầng không đầy đủ
- safety concern (n): mối lo ngại về an toàn • densely populated (a): dân cư đông đúc
• perceived risk (n): rủi ro đã được nhận thức
- voice the concern (v): bày tỏ mối quan ngại
• undermine confidence (v): Làm suy yếu niềm tin
• transportation purpose (n): mục đích giao thông
• Launch education and awareness campaign (v): phát động chiến dịch giáo dục và nâng cao nhận thức
• economic benefit (n): Lợi ích kinh tế
• cycling-friendly (a): thuận tiện cho xe đạp, hỗ trợ cho việc đi xe đạp
Discern between right from wrong= discriminate right from wrong: phân biệt đúng sai 
To be far from convincing : không thuyết phục
Run counter to something : đi ngược lại với / không đồng nhất với
get on like a house on fire: Mối quan hệ cực kỳ thân thiết.
Live purposefully ( adj): sống có mục đích
Income disparity: Chênh lệch thu nhập
• mode of transport (n): phương tiện giao thông
• urban planner (n): nhà quy hoạch đô thị
• cycle track (n): tuyến đường dành cho xe đạp
• bike-sharing program (n): chương trình xe đạp công cộng
• cycling culture (n): văn hóa đi xe đạp
• showcase successful example (v): trình bày ví dụ thành công
human-like intelligence /ˈhjuːmən laɪk ɪnˈtelɪdʒəns/: trí thông minh giống người
get into trouble with /ɡɛt ˈɪntu ˈtrʌbəl wɪθ/: gặp rắc rối với
voice recognition system: hệ thống nhận dạng giọng nói
pose a threat to: gây mối đe dọa
virtual assistant: trợ lý ảo
facial recognition algorithms: thuật toán nhận dạng khuôn mặt
natural language processing: xử lý ngôn ngữ tự nhiên
an AI arms race: cuộc chạy đua vũ trang AI
Ultralight: Siêu nhẹ
Groan(C2): than vãn
wrongful conviction: bản án sai lầm
Caricature: tranh biếm họa
Dizziness and lightheadness: chóng mặt+choáng váng
Working performance anxiety: lo lắng về hiệu suất làm việc
Industrial factory’s fumes: khói thải của nhà máy CNo
Pink slip: giấy sa thải
culprit: thủ phạm
twig: cành cây
remoteness(n): xa xôi
Bonhomie= friendly
Pollinator: loài thụ phấn
Consultancy: sự tư vấn
Whistler-blower: người tố giác
Nepotism: chủ nghĩa gia đình trị
Corruption(C1): tham nhũng
Pseudonymous: bút danh
Pristine: Kiểu mới tinh khôi, chiếu mới=))
work exceptionally hard: làm việc auto chăm chỉ
Amass knowledge = accumulate knowledge: tích lũy kiến thức
Dwindling natural resource: TNTN đag dần cạn kiệt


vivaculous: hoạt bác
inventive: sáng tạo
humanitarian: nhân đạo
compassionate: đồng cảm, từ bi
arrogant: ngạo mạn
eloquent: có tài hùng biện
lazy = sedentary lifestyle = indolent Sluggish(chậm chạp) /slothful/inactive/dull/shiftless
Sad ≈ down in the dump ≈ melancholy(u sầu lâu dài)≈glommy(bí xị)≈ depressed(buồn đến chán nản)≈ distraught(quẫn trí)

